____G__X
________
X______X
__XXXX__
__S__X__