____S__X
________
X______X
__XXXX__
__G__X__